3,2,2
3,2,3,-24
-
000000000
011111310
011211110
011211110
011211110
000000000
-
000000000
010000000
010000000
010000000
000100000
000000000
-
000000000
010000000
011000000
000000000
000000000
000000000
-
000000000
010000000
001000000
000000000
000000000
000000000
-
000000000
000000000
000000000
000000000
000000000
000000000
-