3,2,3
-
000000000
011111110
011111110
011111110
011111110
000000000
-
000000000
010000000
010000000
010000000
000100000
000000000
-
000000000
010000000
001000000
000000000
000000000
000000000
-
000000000
000000000
000000000
000000000
000000000
000000000
-